[
  {
    "type": "mapgen",
    "method": "json",
    "om_terrain": [ "start_loc" ],
    "object": {
      "rows": [
        "                        ",
        "                        ",
        "                        ",
        "                        ",
        "                        ",
        "                        ",
        "      ##############    ",
        "      #            #    ",
        "      #            #    ",
        "      #            #    ",
        "      #            #    ",
        "      #            #    ",
        "      #            #    ",
        "      #######+######    ",
        "                        ",
        "                        ",
        "                        ",
        "                        ",
        "                        ",
        "                        ",
        "                        ",
        "                        ",
        "                        ",
        "                        "
      ],
      "terrain": { " ": "t_grass", "#": "t_wall", "+": "t_door_c" }
    }
  }
]
